111111111111111111111
101010100000001010111
101010100000001010111
101111111111111111111
111011100000000000001
111111100000000000000
111111111111111111111


