010111000001100011000101110110001
000110111101110111001110001011111
011101000001111111110010010101100
001111000011011010111100010100110
010001001010100010001011100101001
100000110011011011011001111010101
010110101101100110001101111110010
001001001001111111111011101101011
100011101010010100011001000110010
100000100100111101101010010001111
100111101010110001101100110110000
111010100100110101100000101010001
001010000101101010000100111110110
101101001110011101000001011100111
110111100111010100111001101100001
000000111100110100011010011001100
000100011101010111110001000010101
111000101111010000100010100011000
101010101000000000101001010000001
101001010101000001010100010100111
111111010101010100100000000000101