111101000001000111111010110010011
101111000110000100110010110101110
100000001111111110010101001110000
011001100101011000100011111110000
000010000011010011000101110101001
011001000011001111110101010011110
010110100011100010011010011111000
000011111110100000101001010010011
000101001100010001010000100100100
011111100101000011101101110011010
100011011010101110010110100001100
111100001000100100111100010110001
100111111010011011010000010010001
101111010101010000001111000111110
000000110111101000000011101100010
100110010000110111011101100001010
111100110010011101000111001100001
001001011110100001001000011110010