011010001010111011100100010100010
001111111000110100001011011001011
101101001010111000111110101010110
101001110100001111001001011000111
011101001110111111100000101001011
010011011101001101111010010001000
010001000001001010001000101001110
010111011111000011001100101100010
010001001001100001100011111001011
010111111000010001001100100011100
111001011100110001000101100001011
111111100100100001100001001100100
101100110110000001111001011110010
110110101011010011111111100011111
110101010000101101111001101011010
011111111010011010011010111100110
000110110001010010111110011110110
101111111110110011101111010000011