111111111111111111111
100010000011120000001
100010000010000001001
100011100000000002001
100010000000000002001
100220000010000002001
100010000010000001001
100010000011110000001
100000000110000000001
100000000100001120001
100000000100001000001
100000000100000000001
111111111111111111111