100001101100101100010010001000000
100101010101100001011010000000001
001001110000001100101010110101111
101000110111111010000001101010011
100010111111011110011001011111010
111101111100111110100101100000001
001010001110000011011000100000101
010101010001110111100110000011011
011010010110111111001101100110111
101010010101111101000000011010000
010000100000100011001001101100100
000111000001100101110001011011100
101011011111010111011100100001100
000001001101100110111111111111000
111100001110101011010001111110000
101010101011010011111101011010011
101010100111111100101101010111010
011111001101111000011000101100011