010110001001000010010100011101111
110111110100001001000110100010010
010010010001010000111011010111000
010100000111011010110001110011111
010000110110001101110100000011011
100000101011111010001011010010100
101000011111001101011011001100000
101010110111010111100100010101001
000101010111111111011110010010101
000111111001111011110101100111010
011011010110000100110110101000101
000000001111111011000011111011000
001001111010001110111010001001101
110011001001110110100001110011001
111101011000110000010101001100011
101100111101110111101010100101100
001001000101010101111101010101100
000000001011011011011000000100100