1111111
1010011
1111001
1000001
1000001
1010001
1111101

