1111111
1000001
1010001
1010001
1111111
