111111111111111111111111111111111111111111111
100010111101000111001110000011111000000000001
111000000000010111000010010100000000001111001
100111001100000011110001010011000101000000001
110001000010001000101110010000011111000000001
100000000011101100000111110000000001010001001
110110001001111000111111001000100000000001111
101001001001100112221110100000111111111000001
100011101000010100100010000111110000000000011
100000100100100000001001000001100000111000001
100011101010001101011100001100000000001001001
111010000110001100000100000000000111000000001
101000000001010000111101120001111100000001111
100001110011101000000010120000010000000001001
101111001010100100110110000002221110000001011
100001100100101101000100120000000010000000001
100022201101100000100001000011010000000000011
100002222000010001010002200100001001010000001
100100000000000100101000000000010011100000001
101000100000100000001010011100000001010000011
110000001001101000001001001000100000000000011
110110001001101000111011001000100000000001001
111111111111111111111111111111111111111111111