111111111111111111111111111111111111111111111
100010000011120000001000010000110000000000001
100010000010000001001100010000100000000000001
100011100000000002001210000000100000000000011
100011111000000002001200000000110000000000001
100220000010000002000211111000100000000000001
100010000011110000000100000000000000000000001
100010000110000000000000010000100000000000001
101110000100001120000000010000100000000000001
101110000100001000000000020000100000000000001
100000000100000011111110000000100000000000001
100000000000000000000000000000100000000000001
110000000100000000010000000000100000000000001
100000000111110000010000000000100000000000001
100000000200000000020000000000100000000000001
110000000100000000010000000000100000000000001
100000000100000000011111100000100000000000001
100000000000000000000000000000000000000000001
100000000000000000001000000000000000000000001
100000000100000000001000000000000000000000001
100000000100000000001000000000000000000000001
100000000100000000001000000000000000000000001
111111111111111111111111111111111111111111111